Adria Arjona	Esihle Amara Ndlovu	female	2
Adrien Brody	Niccolò Davide Bianchi	male	2
Al Pacino	Riccardo Fabrizio Bianchi	male	2
Alberto Rossi	Romeo Francesco Sorrentino	male	2
Alessandro de SantisLorenzo Amadeo Bellini	male	2
Alison Brie	Beatrice Johanna Wolf	female	2
Archie Madekwe	Alessio the Undressio	male	2
Astrid Meloni	Sofia Caterina Sorrentino (née Bernardi)	female	2
Aubrey Plaza	Emilia Leonie Richter	female	2
Audrey Hepburn	Corinna Elisabetta Russo (née Milanesi)	female	2
Austin Butler	Jeremiah Rhys Sinclair	male	2
Barry Keoghan	Franklin Hughes	male	2
Ben Barnes	Vicente Carlo Sorrentino	male	2
Benedetta Gargari	Ginevra Elena Russo	female	2
Benedetta Porcaroli	Sophia Martelli	female	2
Bette Midler	Luisa Carmen Ramirez	female	2
Carla Gugino	Esmeralda Isabella Rodriguez	female	2
Celeste Dalla Porta	Serena Giuseppina Bianchi (née Russo)	female	2
Chloe Bennet	Renata Volturi	female	2
Dave Franco	Kurt Hartwin Lund	male	2
Dichen Lachman	Suzuki Kyo Haruka	female	2
Dianna Agron	Eleni Karissa Aetós-Lund	female	2
Dominic West	Reinhardt Gustav Lund	male	2
Eduardt Badaluta	Luca De Santis	male	2
Elle Fanning	Jane Volturi	female	2
Elisa Visari	Alessandra Chiara Bergamaschi (née Sorrentino)	female	2
Emma Thompson	Lavinia Grace Hendricks	female	2
Emma Watson	Lucia Isabella Sorrentino	female	2
Eva Longoria	Sophia Alessia Belotti	female	2
Federico Cesari	Dante Marcello Sorrentino	male	2
Gaetano Bruno	Aurelio Andrea Bergamaschi	male	2
Gary Oldman	Leonardo Marco Belmonte	male	2
Gerardo Cavaliere	Giacomo Giovanni Russo	male	2
Haley Lu Richardson	Felicity Gemma Montgomery	female	2
Harry Styles	Thomas Harlow	male	2
Helena Bonham Carter	Matilda Sophia Andersen	female	2
Henry Cavill	Marcus Volturi	male	2
Ibrahim Keshk	Antonio Marco Russo	male	2
Janhvi Kapoor	Aisha Aadhya Malik	female	2
Jared Padalecki	Oliver Noah Harlow	male	2
Jean Reno	Asterios Nikos Franopoulos	male	2
Jenna Coleman	Bianca Juliett Harlow	female	2
Jessica Lange	Gaelle Amélie Deveraux	female	2
Joan Plowright	Theofania Maria Caras-Dragoumis	female	2
Joan Cusack	Sofía Isabel Domínguez	female	2
Julia Jones	Leah Marie Clearwater	female	2
Julia Roberts	Abigail Rose Collins	female	2
Julian Richings	Theodosius Valerian Barca	male	2
Juliette Binoche	Giada Marcella Bianchi (née Allegretti)	female	2
Kate Siegel	Lila Grace Thompson	female	2
Kathy Bates	Nijolė Laima Davolienė	female	2
Kim Rossi Stuart	Paolo Matteo Sorrentino	male	2
Kit Harington	Eleazar Silas Denali	male	2
Lara Fabian	Valentina Inés Duarte	female	2
Leighton Meester	Fiona Giselle Rochefort	female	2
Lucien Laviscount	Maxime Julien Delacroix	male	2
Lucy Liu	Akira Kenji Sato	female	2
Ludovica Martino	Francesca Lucia Russo	female	2
Mads Mikkelsen	Leonard Bastian Lund	male	2
Margo Martindale	Barbara Eugenia Franks	female	2
Marisa Tomei	Gertrude Miriam Nicholson	female	2
Michele Morrone	Salvatore Enzo Russo	male	2
Max Thieriot	Adam Christopher Miller	male	2
Monica Barbaro	Mariana Lucía Gonzalez	female	2
Monica Bellucci	Alessandra Maria Bianchi	female	2
Nick Offerman	William Arthur Atkins	male	2
Philippine Leroy-Beaulieu	Emma Celestine Boucher	female	2
Polly Holliday	Gladys Agatha Archdale	female	2
Priyanka Chopra	Aisha Fatima Khan	female	2
Rami Malek	Samir Bakir	male	2
Reneé Rapp	Chiara Ilaria Lombardi	female	2
Richard Madden	Harrison James Whitmore	male	2
Riley Keough	Olivia Harriet Calloway	female	2
Rosamund Pike	Alessandra Vittoria Russo (née Castellano)	female	2
Sabrina Carpenter	Sabrina Miranda Volturi	female	2
Salma Hayek	Pauline Estelle Morrison	female	2
Sarah Paulson	Zara Elizabeth Lennox	female	2
Saul Nanni	Matteo Rossi	male	2
Shawn Mendes	Dominic Lucien Harrington	male	2
Shirley Maclaine	Zophia Giulia Barone	female	2
Sydney Sweeney	Sandra Maria Núñez	female	2
Theo James	Kenneth James Sinclair	male	2
Tilda Swinton	Tessa Louise Johnson	female	2
Viola Davis	Juniper Mae Forrester	female	2
Whoopi Goldberg	Virginie Claire Moulin	female	2
Zoey Deutch	Gabriella Harper Rhodes	female	2
